10
10
WWWWWWWWZW
WEEEEEEWEW
WEEEEEEEEW
WEEEEEEEEW
WEEEEEEEEW
WEEEPEEEEW
WEEEEEEEEW
WEEEEEEEEW
WEEEEEEEEW
WWWWWWWWWW
NNNNNNNNNN
NRRRRRRNNN
NRRRRRRRRN
NRRRRRRRRN
NRRRRRRRRN
NGGGGGGGGN
NGGGGGGGGN
NGGGGGGGGN
NGGGGGGGGN
NNNNNNNNNN
XXXXXXXXXX
XXXXXXXXDX
XXXXXXXXXX
XXXXXXXXXX
XXXXXXXXXX
XXXXXXXXXX
XXXXXXXXXX
XXXXXXXXXX
XXXXXXXXXX
XXXXXXXXXX